1;1;1;1;1;1;1;1;1
1;0;1;0;7;0;0;0;1
1;0;1;0;0;0;1;0;1
1;6;1;0;2;0;1;0;1
1;0;1;0;0;0;1;6;1
1;6;1;0;2;0;1;0;1
1;0;1;0;0;0;1;6;1
1;6;1;0;2;0;1;0;1
1;0;1;0;0;0;1;6;1
1;6;1;0;2;0;1;0;1
1;0;1;0;0;0;1;6;1
1;6;1;0;2;0;1;0;1
1;0;1;0;0;0;1;6;1
1;0;1;0;0;0;1;0;1
1;0;0;0;3;0;1;0;1
1;1;1;1;1;1;1;1;1
